*******
*o   o*
*   o *
*  K  *
*******